000010000000000000000000000000000000000000000000
000010000000000000000000000000000000000000000000
000010000000000000000000000000000000000000000000
000010000000000000000000000000000000000000000000
000010000000000000000000000000000000000000000000
111011111111111111111111111111111100000000000000
001000000000000000000000000000000100000000000000
001011111111111110111111111111110100000000000000
001000000000100010000000000000100100000000000000
001010100100101010111111111110101100000000000000
001010101110001010100000000010100100000000000000
001010100000101010101111101010110100000000000000
001010101111101010101000000010100100000000000000
001000000000001010101111011110101100000000000000
001011111111111010100001000000100100000000000000
001000000000000010111101111111110100000000000000
001111110111111110000000000000000100000000000000
001000000100000000111111111111110100000000000000
001010111111111010100100010000000100000000000000
001010100010001010000001000010110100000000000000
001110101000101010110111110101100100000000000000
001010101111101010100100000010110100000000000000
001000000010000010100000100100000100000000000000
001111111111111111111111111111111100000000000000
000000000000000000000000000000000000000000000000
000000000000000000000000000000000000000000000000
000000000000000000000000000000000000000000000000
