000000000000000000000000000000000000000000000000
000000000000000000000000000000000000000000000000
000000000000000000000000000000000000000000000000
000000000000000000000000000000000000000000000000
000000000000000000000000000000000000000000000000
000000000000000000000000000000000000000000000000
000222222222222222222222222222222222222222222000
000200010100000000000000000010000000000000002000
000201110101111111111110111010111101111110112000
000200000101000001000010001000100000000000102000
000201110101110101011010101111101111101110102000
000200000100000100001000100010000000000100102000
000211011101111111111011111111111111110000002000
000201010101000000000000000000000000010111102000
000201000101000222002002022200222220010100002000
000201110101000200202002020020002000010101012000
000200000100000222002002022200002000010101002000
000211011101000200202002020020002000010001002000
000201000101000222000220022200002000011011102000
000201010101000000000000000000000000010010002000
000200010101111111111111111111111111110010112000
000211110100000000000001010001000000000011102000
000200000111111010110101000101010010101000102000
000201111100001010100101101101010110101101102000
000200000001100010000100000000000000100100000400
000222222222222222222222222222222222222222222000
000000000000000000000000000000000000000000000000
