000000000000000000000000000000000000000000000000
000000000000000000000000000000000000000000000000
000000000000000000000000000000000000000000000000
000000000000000000000000000000000000000000000000
000000000000000000000000000000000000000000000000
000000000000000000000000000000000000000000000000
000222222222222222222222222222222222222222222000
000200010100000000000000000010000000000000002000
000201110101111111111110111010111111111110102000
000200000101000001000010001000100000000010102000
000201110101110101011010101111101111101110102000
000200000100000100001000100010000000101000102000
000211011101111111111111111111111110101110102000
000201010100000000000000000000000000100010102000
000201000100220020020020200222022200111010102000
000201110102002020020202020200020020101010102000
000200000102222022220200020220020020101110102000
000211011102002020020205020200020020100000102000
000201000102002020020200020222022200101111102000
000201010100000000000000000000000000111000002000
000200010101111111111111111111111110100010112000
000211110100000000000001010001000000101110102000
000200000111111010110101000101010010101000102000
000201111100001010100101101101010110101111102000
000200000001100010000100000000000000100000000400
000222222222222222222222222222222222222222222000
000000000000000000000000000000000000000000000000
