000000000000000000000000000000000000000000000000
000000000000000000000000000000000000000000000000
000000000000000000000000000000000000000000000000
000000000000000000000000000000000000000000000000
000000000000000000000000000000000000000000000000
000000000000000000000000000000000000000000000000
000002222222222222222222222222222222222222200000
000002500000001000000101010101010100001000200000
000002010010001001010001010000010111101010200000
000002111110100011011111011111010000000010200000
000002000000101001000001000100000101111011200000
000002111010111111111101010111010101000000200000
000002000010000001000001010000010101011011200000
000002011011111111011111010111010101001010200000
000002001010100001010000000101010001001010200000
000002011010101111011111010101010111111011200000
000002010000100010000001010001010000000000200000
000002010111111011110101111101011011101111200000
000002110100001000000100000001000010100000200000
000002000101101011011101110111011010101110200000
000002010100101010000001010100010010001000200000
000002010110101011111101010111111010111111200000
000002010000100000010000010001000010000000040000
000002010111111011011101010101111011010111200000
000002010100000001010001000101001000010001200000
000002222222222222222222222222222222222222200000
000000000000000000000000000000000000000000000000
